Sentence	label_name	label_ID	language
The moral and ethical implications of same-sex marriage are central to the debate, as the recognition of same-sex couples challenges deeply-held beliefs about the nature of marriage and family.	Morality	3	en
Our faith traditions call on us to recognize the dignity and worth of every person, regardless of their immigration status, and to work for just and humane policies that protect the most vulnerable among us.	Morality	3	en
The moral implications of immigration policy go beyond our obligation to care for those in need, as our policies can also have far-reaching economic, social, and political consequences.	Morality	3	en
The moral and ethical implications of immigration policy are particularly pronounced when it comes to children, who are often subject to harsh treatment and trauma as a result of our policies.	Morality	3	en
Our moral and ethical values as a nation demand that we provide protection and support to refugees and asylum seekers fleeing violence and persecution, regardless of their national origin or religion.	Morality	3	en
Immigrants have always been an essential part of our nation's history and economy, and it's important that we recognize their contributions and promote fairness and equality.	Fairness and Equality	4	en
Immigrants should be treated with dignity and respect, and provided with the resources and opportunities necessary to succeed and contribute to our society.	Fairness and Equality	4	en
A fair immigration system should prioritize family reunification and provide a path to citizenship for all undocumented immigrants.	Fairness and Equality	4	en
Our immigration policies must be guided by the principles of fairness and equality, which means treating all individuals with respect and dignity and providing them with the opportunity to contribute to our society.	Fairness and Equality	4	en
The principles of fairness and equality require that we recognize the rights and dignity of same-sex couples, and provide them with the same legal recognition and protections as opposite-sex couples	Fairness and Equality	4	en
The jurisprudence of same-sex marriage law must recognize the importance of non-discrimination, freedom of expression, and the right to privacy, while promoting social inclusion and diversity.	Legality, Constitutionality and Jurisprudence	5	en
The government has the authority to regulate immigration, but this authority must be exercised in a manner that respects the due process and equal protection rights of all individuals.	Legality, Constitutionality and Jurisprudence	5	en
The Supreme Court has held that same-sex couples have the right to marry, and this decision is grounded in the principles of individual liberty and equality under the law.	Legality, Constitutionality and Jurisprudence	5	en
The Constitution guarantees equal protection under the law to all individuals, including those in same-sex relationships, and this principle must be upheld by the courts and the government.	Legality, Constitutionality and Jurisprudence	5	en
The government has the responsibility to protect the rights and freedoms of all individuals, including immigrants, and this duty must be upheld by the courts and the government.	Legality, Constitutionality and Jurisprudence	5	en
To address the issue of immigrant integration, policies must be implemented that provide access to healthcare, education, and other essential services.	Policy Prescription and Evaluation	6	en
Policies aimed at promoting economic growth must take into account the contributions of immigrants and ensure that they are able to fully participate in the economy.	Policy Prescription and Evaluation	6	en
To address the issue of discrimination against LGBT individuals, policies must be implemented that provide greater legal protections and ensure that their rights are respected in all areas of life.	Policy Prescription and Evaluation	6	en
Policies aimed at promoting immigrant integration must be implemented in a manner that respects the unique needs of different immigrant communities.	Policy Prescription and Evaluation	6	en
To promote the integration of immigrants into our society, we should provide language and skills training, expand access to healthcare and education, and reduce barriers to employment.	Health and Safety	9	en
The enforcement of immigration laws is a complex and often contentious issue, with many arguing that current policies are both ineffective and discriminatory.	Policy Prescription and Evaluation	6	en
The effectiveness of same-sex marriage laws is often measured by their ability to provide legal recognition and protections to same-sex couples.	Crime and Punishment	7	en
The enforcement of immigration laws has been shown to have negative implications for both the individuals targeted and the wider community.	Crime and Punishment	7	en
The implications of same-sex marriage laws go beyond legal recognition, with many arguing that they can have a positive impact on mental health and wellbeing.	Health and Safety	9	en
The enforcement of immigration laws is often criticized for its impact on families, with many arguing that it can lead to separation and trauma.	Crime and Punishment	7	en
Critics of immigration policies argue that they have contributed to rising crime rates and other security threats in the United States.	Crime and Punishment	7	en
Same-sex marriage has been linked to national security concerns in some countries where homosexuality is still criminalized.	Security and Defense	8	en
Some argue that the government's efforts to combat illegal immigration have had a negative impact on the welfare of migrant families and communities.	Security and Defense	8	en
Same-sex marriage has been recognized as a basic human right by many international organizations and human rights groups.	Security and Defense	8	en
Immigration policies must be implemented in a manner that ensures national security and protects against potential threats.	Policy Prescription and Evaluation	6	en
Same-sex couples have faced barriers to accessing healthcare, including denial of spousal benefits and discrimination from healthcare providers.	Health and Safety	9	en
Cultural competency training for healthcare providers can improve the quality of care for immigrant and LGBTQ patients.	Quality of Life	10	en
Lack of access to healthcare can have serious health consequences for undocumented immigrants, including preventable illnesses and untreated conditions.	Health and Safety	9	en
Immigrants who fear deportation may avoid seeking healthcare, which can lead to delayed treatment and worse health outcomes.	Health and Safety	9	en
Sanitation in detention centers for immigrants has been found to be inadequate, leading to health risks for detainees.	Health and Safety	9	en
Immigrants often face significant challenges in integrating into a new society, which can impact their quality of life and well-being.	Quality of Life	10	en
Same-sex marriage provides legal recognition and protections for LGBTQ+ individuals and their families, contributing to an overall higher quality of life.	Quality of Life	10	en
However, anti-immigrant sentiment can lead to discrimination and exclusion, negatively impacting the quality of life for immigrants and their families.	Quality of Life	10	en
Marriage equality can improve the mental health and well-being of LGBTQ+ individuals by reducing the stigma and discrimination they face.	Quality of Life	10	en
Opponents of same-sex marriage argue that it threatens traditional family values, potentially harming the quality of life for some individuals.	Quality of Life	10	en
The issue of immigration is deeply connected to questions of cultural identity, national sovereignty, and globalism.	Cultural Identity	11	en
Immigrants bring with them a rich tapestry of cultural traditions and customs that can enhance the cultural diversity of a society.	Cultural Identity	11	en
The debate over same-sex marriage is fundamentally about cultural norms and values, and the role of the state in regulating personal relationships.	Cultural Identity	11	en
Immigration policies that fail to recognize the cultural identities of immigrants risk creating a society that is hostile to diversity and social cohesion.	Cultural Identity	11	en
Same-sex marriage is a reflection of changing cultural attitudes towards gender and sexuality, and the role of the state in regulating personal relationships.	Cultural Identity	11	en
Despite public opinion polls indicating broad support for same-sex marriage, there remains a significant minority of Americans who oppose it.	Public Opinion	12	en
Polls have shown that the issue of immigration is particularly contentious among certain segments of the population, including white working-class voters and older Americans.	Public Opinion	12	en
Public opinion polls have shown that support for same-sex marriage is highest among college-educated Americans and those who identify as Democrats.	Public Opinion	12	en
Despite the fact that public opinion polls consistently show that Americans support a path to citizenship for undocumented immigrants, politicians have been hesitant to take action on the issue.	Public Opinion	12	en
Polls have shown that the issue of same-sex marriage is particularly salient among younger Americans, who are more likely to identify as LGBTQ+ and to support marriage equality.	Public Opinion	12	en
The role of money in politics is a major factor in the immigration reform debate, with wealthy donors using their resources to influence the views of politicians and sway public opinion.	Political	13	en
Conservative politicians often frame their opposition to immigration as a matter of national security, using fear-mongering tactics to galvanize their base and drum up support for stricter immigration policies.	Political	13	en
The debate over same-sex marriage has forced many politicians to take a stance on a highly controversial and polarizing issue, often at the expense of their personal beliefs or the views of their constituents.	Political	13	en
Lobbyists for both the pro and anti-immigration reform movements have poured millions of dollars into lobbying efforts aimed at influencing elected officials and shaping public opinion.	Public Opinion	12	en
The role of the media in shaping public opinion on issues like immigration and same-sex marriage cannot be overstated, as they have the power to influence the views of millions of Americans through their reporting and commentary.	Political	13	en
The legalization of same-sex marriage in the United States has had a positive impact on LGBTQ rights globally.	External Regulation and Reputation	14	en
The U.S. Department of State has worked to promote LGBTQ rights in countries where discrimination and violence against the community is widespread.	External Regulation and Reputation	14	en
The Obama administration's support for same-sex marriage helped to improve the country's reputation on human rights issues.	External Regulation and Reputation	14	en
The United States' reputation as a leader in democracy and human rights has been undermined by its treatment of immigrants and its failure to provide a path to citizenship for undocumented individuals.	External Regulation and Reputation	14	en
The Trump administration's efforts to restrict immigration from certain countries and to end DACA have damaged the country's reputation as a leader in immigration policy and human rights.	External Regulation and Reputation	14	en
The experiences of LGBTQ immigrants are often erased or ignored in larger discussions around immigration policy and reform.	Other	15	en
Immigration policies can have a significant impact on the health and wellbeing of immigrants and refugees, with factors like access to healthcare and social services playing a crucial role.	Other	15	en
The COVID-19 pandemic has underscored the importance of immigrant workers in sectors like healthcare and food production, highlighting the need for comprehensive immigration reform.	Other	15	en
The rise of far-right populism and anti-immigrant sentiment has put the rights and safety of marginalized communities like immigrants and LGBTQ individuals in jeopardy.	Other	15	en
Immigration policies often prioritize the interests of corporations and employers over the needs and rights of immigrants and refugees.	Quality of Life	10	en
The surge of migrants at the southern border has overwhelmed the current capacity and resources of the U.S. immigration system	Capacity and Resources	2	en
Many immigrant communities lack access to critical resources, such as healthcare and education, due to language barriers and other systemic issues.	Capacity and Resources	2	en
The immigration system is in desperate need of reform to address the backlog of cases and ensure that individuals receive a fair and timely hearing.	Capacity and Resources	2	en
The lack of available resources and support for refugees can lead to long-term integration challenges and a strain on host communities.	Capacity and Resources	2	en
Immigration policies must take into account the availability of jobs and resources to support both immigrants and the existing population.	Capacity and Resources	2	en
Immigrants contribute to the economy by filling gaps in the labor market and starting new businesses.	Economic	1	en
The cost of deporting millions of undocumented immigrants would be astronomical, while legalization would generate significant economic benefits.	Economic	1	en
Immigration has a positive net impact on the U.S. economy, generating growth and creating jobs.	Economic	1	en
The current immigration system places a significant burden on employers, who must navigate complex legal requirements and face uncertainty in hiring practices.	Economic	1	en
The high cost of legal immigration can be a barrier to entry for many individuals, particularly those from low-income backgrounds.	Economic	1	en
Immigration policy is not just an issue of law and order, but also of justice and compassion, as we must balance our obligation to enforce the law with our responsibility to protect the human rights and dignity of all people.	Morality	3	en
Opponents of same-sex marriage argue that it undermines the moral foundation of society, while supporters maintain that it is a matter of justice and equality.	Morality	3	en
The Universal Declaration of Human Rights recognizes the right of every person to seek asylum from persecution, and it is our moral obligation to provide that protection.	Morality	3	en
Many religious traditions have evolved to embrace LGBTQ individuals and their relationships, recognizing the inherent dignity and worth of all people.	Morality	3	en
Our moral and ethical values as a society demand that we respect the rights and dignity of all people, regardless of their sexual orientation or gender identity, and that we work to create a more inclusive and just society for all.	Morality	3	en
The essence of a fair society is that everyone should be able to get ahead on the basis of their own talent and hard work, regardless of their background or circumstances.	Fairness and Equality	4	en
The issue of same-sex marriage is fundamentally about fairness and equality, as it challenges the systemic discrimination and exclusion that have historically limited the rights and opportunities of LGBTQ+ individuals	Fairness and Equality 	4	en
Many religious traditions have long held that marriage is a sacred bond between a man and a woman, which has led to opposition to same-sex marriage on moral and ethical grounds.	Morality	3	en
Same-sex couples should not be forced to navigate a complex legal system to secure basic rights and protections that opposite-sex couples take for granted.	Fairness and Equality	4	en
Our faith traditions call on us to recognize the dignity and worth of every person, regardless of their immigration status, and to work for just and humane policies that protect the most vulnerable among us.	Morality	3	en
The jurisprudence of immigration law must recognize the importance of balancing the competing interests of national security, economic growth, and human rights while ensuring that our policies are both effective and humane.	Legality, Constitutionality and Jurisprudence	5	en
The authority of the executive branch to regulate immigration is subject to judicial review and constitutional constraints, and must be exercised in a manner that is consistent with our values and principles of democracy.	Legality, Constitutionality and Jurisprudence	5	en
The legality and constitutionality of same-sex marriage is grounded in principles of equal protection, due process, and the fundamental rights of all individuals.	Legality, Constitutionality and Jurisprudence	5	en
Immigration laws must be designed to protect the public interest, while also respecting the constitutional rights of immigrants and their families.	Legality, Constitutionality and Jurisprudence	5	en
The authority of states to regulate same-sex marriage is limited by the U.S. Constitution and the principle of federalism, and must be exercised in a manner that is consistent with our obligations under international human rights law.	Legality, Constitutionality and Jurisprudence	5	en
To reduce the backlog of immigration cases, we should increase the number of immigration judges, expand access to legal representation, and streamline our administrative processes.	Legality, Constitutionality and Jurisprudence	5	en
To ensure that same-sex couples have access to the same legal rights and protections as opposite-sex couples, we should adopt policies that recognize same-sex marriage as a fundamental right and prohibit discrimination on the basis of sexual orientation.	Policy Prescription and Evaluation	6	en
Policies aimed at promoting diversity and inclusion in the workplace can help to reduce discrimination against immigrants and LGBT individuals.	Policy Prescription and Evaluation	6	en
To promote the economic integration of immigrants, policies must be implemented that provide access to education and job training programs.	Policy Prescription and Evaluation	6	en
To address the issue of workplace discrimination against LGBT individuals, policies must be implemented that provide greater legal protections and ensure that their rights are respected.	Policy Prescription and Evaluation	6	en
Same-sex marriage laws have been shown to have positive implications for the mental health and wellbeing of not only LGBTQ+ individuals, but also their friends and families.	Health and Safety	9	en
The effectiveness of immigration laws is often questioned in the context of larger debates about global migration patterns and the role of borders in a globalized world.	Crime and Punishment	7	en
The effectiveness of immigration laws in deterring unauthorized migration has been widely debated, with many experts arguing that such laws are both ineffective and costly.	Crime and Punishment	7	en
The criminalization of same-sex relationships and marriage has been used to justify the denial of asylum to LGBTQ+ refugees, many of whom face persecution and violence in their home countries.	Crime and Punishment	7	en
Laws criminalizing same-sex relationships and marriage have been used to justify violence and discrimination against LGBTQ+ individuals, often with little or no recourse to legal protections.	Crime and Punishment	7	en
To protect the security of the nation, policies must be enacted that ensure that individuals entering the country do not pose a threat to public safety.	Security and Defense	8	en
Policies aimed at promoting the safety and well-being of immigrant children must take into account the potential security risks posed by human trafficking or other forms of exploitation.	Security and Defense	8	en
To address the issue of workplace discrimination against immigrants, policies must be implemented that ensure their safety and protection from harassment or violence.	Security and Defense	8	en
To protect the security of the nation, policies must be enacted that ensure that individuals who pose a threat to national security are properly identified and prevented from entering the country.	Security and Defense	8	en
Policies aimed at promoting the rights of immigrants must take into account the potential security risks posed by individuals with criminal histories or terrorist affiliations.	Policy Prescription and Evaluation	6	en
Discrimination against LGBTQ individuals in healthcare settings can lead to lower rates of preventative care and worse health outcomes.	Health and Safety	9	en
The Affordable Care Act has expanded access to healthcare for many immigrants, but some still face barriers due to their immigration status.	Health and Safety	9	en
Lack of access to healthcare can have serious health consequences for undocumented immigrants, including preventable illnesses and untreated conditions.	Health and Safety	9	en
The fear of deportation can deter immigrants from seeking healthcare, which can lead to delayed treatment and worse health outcomes	Health and Safety	9	en
Language barriers can prevent immigrants from understanding how to access healthcare services and how to take care of their health.	Health and Safety	9	en
Marriage equality can provide stability and security for LGBTQ+ families, improving their quality of life and well-being.	Quality of Life	10	en
same-sex marriage can lead to increased social support and sense of belonging for LGBTQ+ individuals, improving their overall well-being and quality of life.	Quality of Life	10	en
Immigrants who face discrimination in the workplace may experience lower job satisfaction and reduced quality of life.	Quality of Life	10	en
Immigrants who are separated from their families due to immigration policies may experience emotional and psychological distress, negatively impacting their quality of life.	Quality of Life	10	en
Opponents of same-sex marriage argue that it can have negative impacts on children raised in such households, potentially harming their quality of life.	Quality of Life	10	en
Immigrants can contribute to the preservation of cultural heritage while also embracing the values and customs of their new home.	Cultural Identity	11	en
Same-sex marriage is a reflection of changing cultural attitudes towards the rights of LGBTQ+ individuals, and the recognition of their relationships as equal to heterosexual relationships.	Cultural Identity	11	en
Immigrants can enrich the cultural diversity of a society while also contributing to the economic and social fabric of their new home.	Economic	1	en
Same-sex marriage represents a shift in cultural attitudes towards the importance of gender and sexuality in personal relationships, and the recognition of LGBTQ+ rights as human rights.	Cultural Identity	11	en
Cultural differences can create tensions and misunderstandings between immigrants and the local community.	Cultural Identity	11	en
Polls have shown that immigration is an increasingly important issue for voters, particularly in states with large immigrant populations.	Public Opinion	12	en
Public opinion polls have shown that attitudes toward same-sex marriage are strongly correlated with religious affiliation, with those who identify as religious being more likely to oppose it.	Public Opinion	12	en
According to a Gallup poll, as of 2021, 84% of Americans believe that immigrants are a good thing for the country.	Public Opinion	12	en
A Pew Research Centre survey found that the majority of Americans (58%) believe that immigrants strengthen the country through their hard work and talents.	Public Opinion	12	en
A study by the National Bureau of Economic Research found that the wages of U.S.-born workers are generally not negatively affected by the presence of undocumented immigrants in the workforce.	Public Opinion	12	en
The fight for same-sex marriage has become a key issue in the culture wars, with politicians on both sides of the aisle using it to appeal to their base and galvanize their supporters.	Political	13	en
The issue of immigration reform has become increasingly polarized in recent years, with politicians on both sides of the aisle unwilling to compromise or find common ground on the issue.	Political	13	en
Same-sex marriage is often framed as a civil rights issue, with supporters arguing that denying LGBT individuals the right to marry is a form of discrimination and inequality.	Political	13	en
Liberal politicians often use their support for same-sex marriage as a way to attract young voters.	Political	13	en
The fight for immigration reform has brought together a diverse group of activists and advocates.	Political	13	en
The legalization of same-sex marriage in the United States has helped to set a positive example for other countries and has contributed to the advancement of LGBTQ rights globally.	External Regulation and Reputation	14	en
The United States' support for same-sex marriage and LGBTQ rights has become an important component of its foreign policy and its efforts to promote democracy and human rights globally.	External Regulation and Reputation	14	en
The United States has a long history of welcoming immigrants, but in recent years, its policies have been criticized for being overly restrictive and damaging to the country's reputation.	External Regulation and Reputation	14	en
The United States' reputation as a global leader in democracy and human rights has been undermined by its treatment of immigrants, particularly those from Muslim-majority countries.	External Regulation and Reputation	14	en
The Biden administration is rolling back some of the Trump-era immigration policies that damaged America's reputation on the global stage.	External Regulation and Reputation	14	en
The intersection of immigration and environmental justice is increasingly recognized, with climate change leading to displacement and migration of vulnerable populations.	Other	15	en
Same-sex marriage is not just a legal issue, but a deeply personal one for many LGBTQ individuals who have been denied the right to marry and have their relationships recognized.	Other	15	en
The experiences of LGBTQ immigrants can vary greatly depending on factors like country of origin, race, and socio-economic status.	Other	15	en
The COVID-19 pandemic has exposed the flaws in our immigration and healthcare systems, revealing the urgent need for systemic change.	Other	15	en
Same-sex marriage has led to greater visibility and acceptance of LGBTQ individuals and families, but it is not the end goal of the broader movement for LGBTQ rights.	Other	15	en
The lack of legal recognition for same-sex couples can lead to a lack of access to critical resources, such as healthcare and social security benefits.	Capacity and Resources	2	en
Many same-sex couples face financial challenges due to the lack of legal protections for their relationships, such as inheritance rights and joint tax filing.	Capacity and Resources	2	en
The legal recognition of same-sex marriage can bring important economic benefits, such as increased tourism and business revenue.	Economic	1	en
The lack of legal recognition for same-sex couples can lead to social isolation and a lack of support from friends and family.	Other	15	en
The legal recognition of same-sex marriage can help to foster a sense of community and belonging among LGBTQ individuals and their families.	Capacity and Resources	2	en
The legal recognition of same-sex marriage can generate significant economic benefits, such as increased tourism and business revenue	Economic	1	en
The legalization of same-sex marriage can lead to increased economic mobility and financial security for LGBTQ individuals and their families.	Economic	1	en
The cost of defending anti-gay marriage laws in court can be significant, with many states spending millions of dollars on legal fees.	Economic	1	en
The legal recognition of same-sex marriage can promote economic growth and stability by reducing discrimination and ensuring equal protection under the law	Economic	1	en
The legal recognition of same-sex marriage can improve access to critical resources such as healthcare, social security benefits, and survivor benefits.	Economic	1	en